11111
1P0C1
100E1
1C001
11111
