1111111
1P0C001
100E1C1
1C00C01
1111111
